NO 12345.xpm
SO 12345.xpm
WE 12345.xpm
EA 12345.xpm

F 45678
C 89012

11111
10N01
11111
