NO textures/North.xpm 							
EA textures/East.xpm
WE 			textures/West.xpm
SO textures/South.xpm		

C 10,210,180
F 150,210,20


1111
10N1
1111


111110
