NO textures/North.xpm
SO textures/South.xpm
WE textures/West.xpm
EA textures/East.xpm

F 220,100,0
C 225,30,0

1111111
100000111111111111111
1000000000000000000011
1000000000000S00000001

1000000000000000000011
100000111111111111111
1111111
