NO textures/North.xpm
SO textures/South.xpm
WE textures/West.xpm
EA textures/East.xpm

F 220,100,0
C 225,30,0

    11111          11111
   1000001        1000001 
  100000001      100000001
 1000W00001      1000000001
100000000001    100000000001
100000000001    100000000001
1000000000001111000000000001
1000000000010000100000000001
 10000000000000000000000001
 10000001110000001110000001
  110001000100001000100011
    10010000000000001001
   1010000010000100000101
   1000110010110100110001
  10000001101  10110000001
  100110000001100000011001
  101001000000000000100101
  100010000011110000010001
   100000001    100000001
    100000001  100000001
     100000001100000001
      1110000000000111
         1111111111
