NO textures/North.xpm
SO textures/South.xpm
WE textures/West.xpm
EA textures/East.xpm

F 220,100,0
C 225,30,0

1111111
1000001
1000001
1111111

1111111
110W011
1110111
1111111
