NO textures/North.xpm
SO textures/South.xpm
WE textures/West.xpm
EA textures/East.xpm

F 220,100,0
C 225,30,0

111111111111111
10N000000000001
100011111100001
10001     10001
10001  0  10001
10001     10001
100011111110001
100000000000001
111111111111111
