NO textures/North.xpm
SO textures/South.xpm
WE textures/West.xpm
EA textures/East.xpm

F 220,100,0
C 225,30,0

11111W1
10000011
1000001
1111111
