NO textures/North.xpm
SO textures/South.xpm
WE textures/West.xpm
EA textures/East.xpm

F 220,100,0
C 225,30,0

11111111111111
100000000000001
100000111100001
1000E01  100001
100000111100001
100000000000001
11111111111111
