NO textures/North.xpm
SO textures/South.xpm
WE textures/West.xpm
EA textures/East.xpm

F 220,100,0
C 225,30,0

1111111
100000111111111111111
100000000000000000001
111111111111111110001
                10001111111111111111111
1111111111111111100000000000000S00000001
1000000000000000000011111111111111111111
1110000000000000000000000000000000000001
  1100000000111111111000000000000111111
  110000000011     110000000000001
 11100000000011   110000000000001
 1100000000000011100000000000001
 111000000000000100000000000001
  1100000000000000000000000011
1110000000000011111110000011
11111100000000111  1110001
11111100000000011  110001
11111000000000001  10001
11111000011111111111001
10000000000000000000001
1000000000001111111111
110000000011
100000000011
1000000000001
11111110000011
       111111
