NO textures/redbrick.xpm 							

SO textures/greystone.xpm		
WE 			textures/mossy.xpm
EA textures/wood.xpm

F 150,210,20
C 10,210,180

1111111111
100N0000001
10000000001
10000111001
100001 1001
10000111001
10000000001
11111111111	
101
11
11111111111
1111111111
