NO textures/North.xpm
SO textures/South.xpm
WE textures/West.xpm
EA textures/East.xpm

F 220,100,255
C 225,150,225

1111111
1000001
10E0001
1000001
10E0001
1000001
10000E1
1111111
