NO textures/North.xpm
SO textures/South.xpm
WE textures/West.xpm
EA textures/East.xpm

F 1,0,2
C 7,9,6

11111
10N01
11111
