NO textures/North.xpm
SO textures/South.xpm
WE textures/West.xpm
EA textures/East.xpm

F 138,10,25,28
C 194,100,1i

11111
10N01
11111
