NO textures/North.xpm
SO textures/South.xpm
WE textures/West.xpm
EA textures/East.xpm

F 220,1,25
C 225,1,22

11111
10N01
11111
