NO textures/North.xpm
SO textures/South.xpm
WE textures/West.xpm
EA textures/East.xpm

F 30,60,150
C 30,150,240

11111
10N01
11111
