NO textures/North.xpm
SO textures/South.xpm
WE textures/West.xpm
EA textures/East.xpm

F 150,210,20
C 10,210,180

11111
10N01
11111
