NO textures/North.xpm
SO textures/South.xpm
WE textures/West.xpm
EA textures/East.xpm

F 22a,1,20
C 15,r,55

11111
10N01
11111
